WWWWWWWWW
W      GW
W  WWWWWW
WW  WWWWW
W       W
WWW    PW
WWWWWWWWW